{
	"rows": [
		"S                           ",
		"S-----------                ",
		"H     H     # $ #     H     ",
		"H $  HHH  $ ##### $  HHH  $ ",
		"H HH  H  HH       HH  H  HH ",
		"H H HHHHH H       H HHHHH H ",
		"H H  $ $  H   H   H  $ $  H ",
		"H  H#####H   HHH   H#####H  ",
		"H   HHHHH HH  H  HH HHHHH   ",
		"H         H HHHHH H         ",
		"H    $    H  $ $  H     $   ",
		"H######H   H#####H  H#######",
		"H      H    HHHHH   H       ",
		"H      H            H       ",
		"H      H       $  & H       ",
		"############################"
	]
}