{
	"rows": [
		"S                           ",
		"S---------------------------",
		"H# 0   #             #     #",
		"H #####               ##### ",
		"H # ###               #$### ",
		"H ##### 0    0      0 ##### ",
		"H ### #X################# # ",
		"H #####X### $## $########H# ",
		"H #####X#################H# ",
		"H #####X#################H# ",
		"H #####X####    #########H# ",
		"H #####X####    #########H# ",
		"H #####X####   $H########H# ",
		"H           ####H--------H  ",
		"H          @@@@             ",
		"H      &  @@@@      0       "
	]
}